20 12
XXXXXXXXXXXXXXXXXXXX
XXXX   XXXXXXXXXXXXX
XXXXXX XXXXXXXXXXXXX
XXXX         XXXXXXX
XXXXXXXX X XXXXXXXXX
XXXXXXXX X    XXXXXX
X        XXXX XXXXXX
  XX XXXXXX      XXX
X XX XXXXXXXXX XXXXX
XXXX XXXXX       X   
XX   XXXXXXXXXXX   X
XXXXXXXXXXXXXXXXXXXX
